NO ./path_to_the_north_texture
SO ./path_to_the_south_texture
WE ./path_to_the_west_texture
EA ./path_to_the_east_texture

F 1,2,3
C 4,5,6

111111111111111111111
100000110011000000011
101110000000011000011
111000110000000000011
100010001100000110011
100010000000111100011
10N010001110000000011
100010001000000010011
11111100100000S011011
100000001011110001011
100000001000000000011
111111111111111111111