NO ./path_to_the_north_texture
SO ./path_to_the_south_texture
WE ./path_to_the_west_texture
EA ./path_to_the_east_texture

F 1,2,3
C 4,5,6

11111111111111111111
10000011001100000001
10111000000001100001
11100011000000000001
10001000110000011001
10001000000011110001
10E01000111000000001
10001000100000001001
11111100100000001101
10000000101111000101
10000000100000000001
11111111111111111111